(更新|增加|修改|删除)资源上的(label|标签).*?(为kubernetes集群的resource打标签)?	command_describe
将已经存在的一个(rc|service|deployment|pod).*?新的service	command_describe
pod频繁重启，在running和crashloopbackoff之间循环	because
根据(配置文件|stdin|资源名称|labelselector)删除资源	command_describe
基于一个镜像在kubernetes集群中启动一个deployment	command_describe
对指定的replicationcontroller执行滚动升级	command_describe
(mon.{1,3}db/proton-)?mon.{1,3}db升级有两个mon.{1,3}dbpodcrash起不来	abnormal
mon.{1,3}db升级有两个mon.{1,3}dbpodcrash(起不来|挂了)	abnormal
mon.{1,3}db升级有两个mon.{1,3}dbpodcrash(起不来|挂了)	abnormal
在running和crashloopbackoff之间循环	because
为replicationcontroller设置新的副本数	command_describe
以.*?(组|版本).*?的格式输出服务端支持的api版本	command_describe
对replicationcontroller进行自动伸缩	command_describe
pod处于terminating或unknown状态	abnormal
pod一直处于crashloopbackoff状态	abnormal
创建kubernetes集群的“?快捷途径”?	command_describe
用于操作kubernetes集群资源对象的命令	command_describe
pod处于imagepullbackoff状态	abnormal
主模块升级完成后proton_etcd起不来	abnormal
proton[-_]etcd起不来	abnormal
etcd起不来	abnormal
proton[-_]etcd报错	abnormal
podruncontainererror状态	abnormal
pod处于running状态但是没有正常工作	abnormal
有两个mongondbpodcrash起不来	abnormal
查看(node|pod)的实时资源使用情况	command_describe
升级过程策略引擎报错podnotready	abnormal
pod处于crashing或别的不健康状态	abnormal
升级过程策略引擎报错podnotready	abnormal
所有podready状态，但不能访问应用	abnormal
podruncontainererror	abnormal
“?副本重启从集群中移除”?行为不必要	because
副本重启从集群中移除	because
通过文件名或控制台输入，对资源进行配置	command_describe
pod中有处于running状态的容器	abnormal
podimagepullbackoff	abnormal
podcrashloopbackoff(状态)?	abnormal
podready.*?不能访问应用	abnormal
描述一个或多个资源对象的详细信息	command_describe
主模块升级后有些pod不能用	unspecific_abnormal
etcdpod显示无法加入集群	because
etcdpod部署为无状态服务	because
通过控制台输入更新资源中的字段	command_describe
通过文件名或控制台输入替换资源	command_describe
pod处于notready状态	abnormal
pod停滞在pending状态	abnormal
pod停滞在waiting状态	abnormal
podterminating	abnormal
(mongodb)?(的)?pod状态(不对|不正确)	abnormal
(mongodb)?(的)?pod.{0,5}crash	abnormal
(mongodb)?(的)?pod(启动不了|启动失败|无法启动)	abnormal
mongodbpodcrash(起不来)?	abnormal
mongdb不能启动	abnormal
mongdb的pod异常	abnormal
mongodb.{0,2}(不能启动|启动失败|升级失败|无法启动)	abnormal
mongodb的pod异常	abnormal
mongodbpod起不来	abnormal
mongodb起不来	abnormal
mongodb.{0,5}异常	abnormal
mongodb报错	abnormal
(mongodb)?(proton_etcd|etcd|pod).{0,2}状态不是running	abnormal
proton[-_]etcd(出现|有)问题	unspecific_abnormal
proton[-_]etcd(为什么)?(不能启动|起不来)	abnormal
proton[-_]etcd出现问题	abnormal
proton[-_]etcd异常	cate
etcd的?pod起不来	abnormal
etcd服务异常	cate
etcd会有问题	cate
etcd状态不对	cate
etcdpod会有问题	cate
etcd.*?(无法启动|不能启动|启动不了|启动失败)	abnormal
etcd.*?不能正常启动	abnormal
etcd.*?(出现故障|出现问题|不能启动|有问题|状态不对|服务异常)	abnormal
etcd.*?(不能启动|启动失败|升级失败|无法启动|状态不对|失败)	abnormal
etcd.*?有问题	abnormal
部分服务起不来	unspecific_abnormal
(升级主模块|主模块升级).{0,3}(pod|etcd|mongodb).{0,3}(不能用|不可用|失败|起不来|报错|不能启动|无法正常工作)	unspecific_abnormal
(升级主模块|主模块升级).{0,3}(pod|etcd|mongodb).{0,3}状态(不对|不可用|不正确|有问题)	unspecific_abnormal
(升级主模块|主模块升级).{0,3}(不能用|不可用|失败|起不来|报错|不能启动|无法正常工作|启动失败|无法使用|无法工作|无法启动)	unspecific_abnormal
(升级主模块|主模块升级).{0,3}状态(不对|不可用|不正确|有问题)	unspecific_abnormal
(主模块)?pod(不能启动|启动失败|升级失败|无法启动|状态不正确|状态不正常|状态不对|描述错误|不能用|不可用|失败|起不来|报错|不能启动|无法正常工作|启动失败|无法使用|无法工作|无法启动)	abnormal
(主模块)?(服务不可用|启动失败|起不来|不能用|不可用|失败|起不来|报错|不能启动|无法正常工作|启动失败|无法使用|无法工作|无法启动)	unspecific_abnormal
mongodb的状态不对	abnormal
(pod|etcd|mongodb).{0,4}(状态)?(不对|不可用|不正确|有问题|不能用|不可用|失败|起不来|报错|不能启动|启动不了|无法正常工作|不能正常工作)	unspecific_abnormal
(显示)?etcd无法加入集群	abnormal
策略引擎报错	abnormal
(主模块)?升级(失败|异常)	unspecific_abnormal
pod的?(常见)?(状态)?(异常|反常|不正常)	cate
pod故障	cate
(proton[-_])?etcd的pod异常	cate
(proton[-_])?etcd(常见)?(状态)?(异常|反常|不正常)	cate
(mon.{1,3}db)?podcrash	abnormal
部分服务起不来	abnormal
mongodbcrash	abnormal
主模块(升级)?(报错|失败|异常)	unspecific_abnormal
主模块无法(升级|启动)	unspecific_abnormal
主模块升级	supgrade_type
pod起不来	abnormal
crash状态的pod	abnormal
(常见)?异常(分类|类别|类型)	cate_type
pod.{0,2}error	abnormal
proton[-_]etcd起不来	abnormal
通过文件或标准输入创建资源	command_describe
在屏幕上打印一个容器的日志	command_describe
获取所有resources	command_describe
pod(处于)?error状态	abnormal
获取资源及其字段的文档	command_describe
将本地端口转发到pod	command_describe
podnotready	abnormal
podnotready	abnormal
podcrashing	abnormal
podpeding	abnormal
podpedin	abnormal
podpending	abnormal
podwaiting	abnormal
podunknown	abnormal
nodenotready	abnormal
设置资源对象的某个	command_describe
显示一个或多个资源	command_describe
k8s集群增加节点	command_describe
在容器内部执行命令	command_describe
pod没有正常工作	abnormal
poderror	abnormal
anyshare	software
pod频繁重启	because
更新资源的注解	command_describe
卷展栏管理展开	command_describe
输出集群信息	command_describe
pod不健康	abnormal
编辑资源	command_describe
(如何|怎么)解决	resolve_type
什么原因|咋回事	because_type
什么办法|咋办|怎么办|怎么处理|如何操作	resolve_type
原因是(什么)?	because_type
为什么	because_type
异常(?=有哪些)	abnormal_type
表现(?=有哪些)	abnormal_type
显示.*?无法	abnormal
显示.*?失败	abnormal
查看as节点	function
v[0-9]+[.]?[0-9.]+	software_version
[0-9][.]?[0-9][.]?[0-9][.]?[0-9]	software_version
k8s	software
as	software
升级报错	supgrade_type